G0W000WW0000W00
00W0W00W0W00WW0
W00000000WW0000
00W0W0WWWW00W0W
W0W000WW0WW0000
WWWW0WW00000W0W
0WWW00W0WW00W00
0W000W00WWW000W
0W0W000000W0WWW
0000W00WW00000U
W0WWWW00WW0WWWU
000WW0000WWW00U
WW0W00W0000WWWU
0W000WW0WW0WW0U
0000WW000LLLLLG
