G0WWW0WW0000WWW
000WW00W0W00WW0
WW00W0000WW0000
WWW0W0WW0WW0WWW
WWW000WW0WW000W
WWWW0WWW0000WWW
WWWW00WWWW00WWW
WW000WWWWWW0WWW
WW0W000WWWW0WWW
W00WW00WWW00WWW
W0WWWW00WW0WWWW
W00WWWW00WWWWWW
WW0WWWW0000WWWW
WW00WWW0WW0WW00
WWWWWWW0000000G